EEEEEEWEEEEEEEEEEEEEEEEEWEEEEEEE
EEEEEEEEEEEEEWEEWEEEEEEEEEEEEEEE
WWWWEEWWWWWWWWEEWWWWWWWWWEEWWWWW
EEEWEEWEEEEEEEEEEEEEEEEEWEEWEEEE
EEEWEEWEEEEEEEEEEEEEEEEEWEEWEEEE
EEEWEEWEEEEEEWWWWEEEEEEEWEEWEEEE
EEEWEEWEEEEEWEEEEWEEEEEEWEEWEEEE
EEWWEEWEEEEWEEEEEEWEEEEEWEEWWEEE
EEEEEEEEEEEEEEWWEEEEEEEEEEEEEEEE
EEEEEEEEEEEEEEWWEEEEEEEEEEEEEEEE
EEWWEEWEEEEWEEEEEEWEEEEEWEEWWEEE
EEEWEEWEEEEEWEEEEWEEEEEEWEEWEEEE
EEEWEEWEEEEEEWWWWEEEEEEEWEEWEEEE
EEEWEEWEEEEEEEEEEEEEEEEEWEEWEEEE
EEEWEEWEEEEEEEEEEEEEEEEEWEEWEEEE
WWWWEEWWWWWWWWEEWWWWWWWWWEEWWWWW
EEEEEEEEEEEEEWEEWEEEEEEEEEEEEEEE
EEEEEEWEEEEEEEEEEEEEEEEEWEEEEEEE