EEEEEWEEEEEEEEWEEEEEEEEEEEWEEEEE
EEEEEWEEEEEWEEWEEWEEEEEEEEWEEEEE
EEEEEWEEEEEEWEWEWEEEEEEEEEWEEEEE
EEEEEEEEEEEEEWWWEEEEEEEEEEEEEEEE
EEEEEEEEEEEEEEWEEEEEEEEEEEEEEEEE
WWWEEEEEWWWEEEEEEEWEEEEEEEEEEWWW
EEEEEEEEWWWEEEEEEEWEEEEEEEEEEEEE
EEEEEEEEWWWEEEEEEEWEEEEEEEEEEEEE
EEEEEEEEEEEEEEWWWWWWWWWWWWWEEEEE
EEEEEWWWWWWWWWWWEEEEEEEEEEEEEEEE
EEEEEEEEEEEWEEEEEEEEEWWWEEEEEEEE
EEEEEEEEEEEWEEEEEEEEEWWWEEEEEEEE
WWWEEEEEEEEWEEEEEEEEEWWWEEEEEWWW
EEEEEEEEEEEEEEEWEEEEEEEEEEEEEEEE
EEEEEEEEEEEEEEWWWEEEEEEEEEEEEEEE
EEEEEWEEEEEEEWEWEWEEEEEEEEWEEEEE
EEEEEWEEEEEEWEEWEEWEEEEEEEWEEEEE
EEEEEWEEEEEEEEEWEEEEEEEEEEWEEEEE