EEEEWEEWWEEEEEWEEEEEEEEWWEEEEEEE
EEEEWEEEEEEEEEWEEEEEEEEWWEEEEEEE
EEEEWEEEEEEEEEWWWWWEEEEEEEEEWEEE
EEEEWEEEEEEEEEEEEEEEEEEEEEEEWEEE
EEEWWWWWWWEEEEEEEEEEEEEEEEEWWWWW
EEEEEEEEEEEEEEEEEEEEEEEEEEEEWEEE
EEEEEEEEEEEEEEEEEEEEEEEEEEEEEEEE
EEEEEEEEEEEEEEWWWWWWWEEEEEEEEEEE
WWWWWEEEEEEEEEWEEEEEWEEEEEEEEEEE
EEWEEEEEEEEEEEWEEEEEWEEEEEWWWWEE
EEWEEEEEEEEEEEWEEEEEWEEEEEEEEEEE
EEWEEEEEEEEEEEEEEEEEWEEEEEEEEEEE
EEEEEEEWEEEEEEEEEEEEEEEEEEEEEEEE
EEEEEEEWEEEEWEEEEEEEEEEEEEEEEEEE
EEEWWWWWWEEEWWEEEEEEEWWWWWWEEEEE
EEEWEEEEEEEEEWEEEEEEEEEEEEWEEEEE
EEEWEEEEEEEEEWEEEEEEEEEEEEWEEEEE
EEEWEEEEEEEEEWEEEEEEEEEEEEWEEEEE